NO textures/wood_strips.xpm
SO textures/wood.xpm
WE textures/wood_box.xpm
EA textures/rocks.xpm

C 103, 193, 202
F 125, 130, 140

1111111111111
1111010010111
1110101101011
1111111111110