NO textures/no.xpm
SO textures/so.xpm
WE textures/we_box.xpm
EA textures/ea.xpm

C 103, 193, 202
F 125, 255, 140
 
        1111111111111111111111111
        1000000000110000000000001
        1011000001110000000000001
        1001000000000000000000001
11111111111111001110000000000001
100000000011N10001110111111111111
11110111111111011100000010001
11110111111111011101010010001
11000000110101011100000010001
11000000000000001100000010001
10000000000111001101010010111
1111111111111111111111111111111
1111111111111111111111111111111
1100000111010101111101111000111
11110111 1111101 101111010001
11111111 1111111 111111111111
11111111111111 1111111111 111