NO ../textures/NO.xpm
SO ../textures/SO.xpm
WE ../textures/WE.xpm
EA ../textures/EA.xpm

F 220,100,0
C 225,30,0

1111111111
1000000001
10000 0001
1000000001
1000000001
1000N00001
1111111111
1000000001
1000010001
11111 1111