NO textures/wood_strips.xpm
SO textures/wood.xpm
WE textures/wood_box.xpm
EA textures/rocks.xpm

C 103, 193, 202
F 125, 130, 140

    1111111111111
11111100100011 1
11111111N1011 111111111
111001111111 111101011
111111111 1111 11111111
11111111111111111111111