NO ../textures/NO.xpm
SO ../textures/SO.xpm
WE ../textures/WE.xpm
EA ../textures/EA.xpm

F 220,100,0
C 225,30,0

1                      1
  1111111111111111111111
 100000100000000000110001
1001111N010110011011101111
 101010101100011100010011
  11111  1111  11111111